R R R R R R R R R G G G G G C G G R R C G G G G R G G C R R R R
R R R R R R R R R G G G G G G G R R R R G G G G R G G G R R R R
R R R R R R R R G G G R G C G G R R R R G R G G G G G G R G C R
R R R R C R R R G G G G R G G G G C R G G R R R G R G G G G G G
R R R R G G G G G G G G G R G G G G R G G R R R G C G G G R G G
R R G G C G G R R G G G C R G G G G G G G R R R G G R C G G G R
R R G G R R G G R R G G R G G R R G G G G R R R R R R G G G G G
R R G G G R G G G R G G C G G G G G G R R C R R R R R G G R G G
R G G G G R R G G R R G R G G R R G R R G G R R R R R G G G G G
R G R R R R R R R R G G C G R R R G G R G G G R R R R R G R R G
R R R R R R R R R R G G R G R R R G G G G G R R R G G G G G C G
R R G G C R R R R R G G C G G R R G G G G G R R R G G C G G G G
R R G G G G R R R R R R R R G R G R G G G G R R R R G G G G G G
R R G G G G G G R R R R R G G R G G G G G G G G C R G G R G C G
R C G G G R G R R R R R G G G G R R R R G G G G R R R R R G G G
R G G G G G G R G R R R G G G G G G R R R R R R R R R R R G G G
G G G G G G G R G G R R G G G G B G R R R R R R R R R R R R R G
G G G G G G R R G R R R R R G G G G G G R R R R R R R R R R R R
R G G G R R R R G R R R R R R G C G G G R R R R R R R R R R R R
R G G G G G G G G R R R R R R G G G G G R R R R R R R R R G R R
R G R R C G G G G R R R C G G G G G R R R R R G G G R R G G R R
R R R G G G G C R R R R R R R R R G G G R R G G G G G R G G G G
R R R G G C G G G G R R R R R G G G G G R R R C R G G R G G G G
R R G G G C G G G R R R R R R G G C G C G R R G R G G G G G G R
R R G G G G G G G R R R R R R R R R G G G G R G R R G R R G C R
R R R C G G G G G G G R R R R R R R G G G G R G G G G R R G G R
R R G G G G C G G G G R R R R R G G G G G R R G R R R C G G G R
R G G G G G C G G G G R R R R R G G G G G G G R R R R G G G G G
R G G G G R R G G G G R G R G G R G G G G R R R R R G G R G G G
R G G G G G R R R G G G G G C G G G G G G R R R R R R R R G G G
G G G R C G G C R G G G G G G G G C G G C R R R R R R R R R G G
G R R R R G G G G G G G G C G G G R G G R R R R R R R R R C G R